ADMINISPHERE: The rarefied organizational layers beginning just above the rank and file. Decisions that fall from the adminisphere are often profoundly inappropriate or irrelevant to the problems they were designed to solve.
ALPHA GEEK: The most knowledgeable, technically proficient person in an office or work group. "Ask Larry, he's the Alpha Geek around here.
ASSMOSIS: The process by which some people seem to absorb success and advancement by kissing up to the boss rather than working hard.
BLAMESTORMING: Sitting around in a group, discussing why a deadline was missed or a project failed, and who was responsible.
BMWs: Bitchers, Moaners and Whiners.
BOBBLEHEADING: The mass nod of agreement, by participants in a meeting, to comments made by the boss; even though most have no idea what he/she just said.
BODY NAZIS: Hard-core exercise and weight-lifting fanatics who look down on anyone who doesn't work out obsessively.
CARBON-BASED ERROR: Error caused by a human, not a computer (which we assume would be a silicon-based error). [Ed note: Sometimes described by Tech Support as being between the keyboard and the chair; the Help Desk flags it as a category One-D-Ten-T ... write it out for yourselves.]
CHAINSAW CONSULTANT: An outside expert brought in to reduce the employee headcount, leaving the top brass with clean hands.
CHIPS AND SALSA: Chips = hardware, Salsa = software. "Well, first we gotta figure out if the problem is in your chips or your salsa."
CLOCKROACHES: Employees who spend most of their day watching the clock -- instead of doing their jobs
CUBE FARM: An office filled with cubicles.
DEATH BY TWEAKAGE: When a product or project fails, due to unnecessary tinkering or too many last-minute revisions.
DEJA POO: The feeling that you've stepped in this bull before.
FLIGHT RISK: Used to describe employees who are suspected of planning to leave a company or department soon.
GENERICA: Features of the American landscape that are exactly the same no matter where one is, such as fast food joints, strip malls, subdivisions.
GOING POSTAL: Euphemism for being totally stressed out, for losing it. Makes reference to the unfortunate track record of postal employees who have snapped and gone on shooting rampages.
GOOD JOB: A "Get-Out-Of-Debt" job. A well-paying job people take in order to pay off their debts, one that they will quit as soon as they are solvent again.
IDEA HAMSTERS: People who always seem to have their idea generators running.
IRRITAINMENT: Entertainment and media spectacles that are annoying but you find yourself unable to stop watching them. The O.J. trials were a prime example. Bill Clinton's video Grand Jury testimony is another.
MENOPORSCHE: Male menopause. Symptoms include a sudden lack of energy, crankiness and the overpowering urge to buy a Porsche.
MOUSE POTATO: The on-line, wired generation's answer to the couch potato.
MUFFIN TOP: The unsightly roll of flesh that spills over the waist of a pair of too-tight jeans.
OHNOSECOND: That minuscule fraction of time in which you realize that you've just made a BIG mistake.
PERCUSSIVE MAINTENANCE: The fine art of whacking the heck out of an electronic device to get it to work again.
PLUTOED: To be unceremoniously dumped or relegated to a lower position, without an adequate reason or explanation.
PRAIRIE DOGGING: When someone yells or drops something loudly in a cube farm, and people's heads pop up over the walls to see what's going on.
RINGTONE RAGE: The violent response by cube-mates, after hearing your annoying cell phone ringtone for the 15th time.
SALMON DAY: The experience of spending an entire day swimming upstream only to get screwed and die in the end.
SEAGULL MANAGER: A manager who flies in, makes a lot of noise, craps on everything, and then leaves.
SITCOMs (Single Income, Two Children, Oppressive Mortgage): What yuppies turn into when they have children and one of them stops working to stay home with the kids.
SQUIRT THE BIRD: To transmit a signal to a satellite.
STARTER MARRIAGE: A short-lived first marriage that ends in divorce with no kids, no property and no regrets.
STRESS PUPPY: A person who seems to thrive on being stressed out and whiny.
SWIPED OUT: An ATM or credit card that has been rendered useless because the magnetic strip is worn away from extensive use.
TOURISTS: People who take training classes just to get a vacation from their jobs. "We had three serious students in class; the rest were just tourists."
TREEWARE: Hacker slang for documentation or other printed material.
UNINSTALLED: Euphemism for being fired. Heard on the voicemail of a Vice President at a downsizing computer firm: "You have reached the number of an uninstalled Vice President. Please dial our main number and ask the operator for assistance." See also Decruitment.
VULCAN NERVE PINCH: The taxing hand position required to reach all the appropriate keys for certain commands. For instance, the arm reboot for a Mac II computer involves simultaneously pressing the Control, Command, Return Key and Power key.
WOOFYS: Well Off Older Folks.
XEROX SUBSIDY: Euphemism for swiping free photocopies from one's workplace.
YUPPIE FOOD STAMPS: The ubiquitous $20 bills spewed out of ATMs everywhere. Often used when trying to split the bill after a meal, "We each owe $8, but all anybody's got are yuppie food stamps."
